barcode	id	variant
CGTGTCATACTAATCAAC	BEAD-1C_FL	WT
ATTAGTGCTAAAGATCGT	BEAD-1C_FL	WT
AATAAAATTGAACATCAG	BEAD-1C_FL	WT
GGCAGTCCAAAGGTAAAG	BEAD-1C_FL	WT
ACCAACGCCATAGGTCCC	BEAD-1C_FL	WT
GCAACCCGAATGGTGACT	BEAD-1C_FL	WT
GTTATTCATATTGAGATA	BEAD-1C_FL	WT
GCTAACCCTATTGCTATG	BEAD-1C_FL	WT
CCTGACAACCCTATGATT	BEAD-1C_FL	WT
GAAATACCCACAGCAAAT	BEAD-1C_FL	WT
AGTACTAAAGATCCTCTA	BEAD-1C_FL	WT
CGAGTCACACATAAAATA	BEAD-1C_FL	WT
ACGAAGGCTAGGGAACTC	BEAD-1C_FL	WT
CAAGTTAAACACAGTACT	BEAD-1C_FL	WT
ATCAGGAGTGTACTACAC	BEAD-1C_FL	WT
ATAAGTAATGCGCTCCAC	BEAD-1C_FL	WT
GGCACACGCAAAGCGAAC	BEAD-1C_FL	WT
CAAGCGACCCTGAGCAAT	BEAD-1C_FL	WT
GTCACACTCAAAGTCAGA	BEAD-1C_FL	WT
CTGGAAATTCCGACGAAA	BEAD-1C_FL	WT
ATGATTAGGGTACTGCAC	BEAD-1C_FL	WT
AATAGTGCCACTGTACAC	BEAD-1C_FL	WT
ATTACCAAGGCCCAACTC	BEAD-1C_FL	WT
CAAGATAATCTTACGAAT	BEAD-1C_FL	WT
AAAACGATTGGACTCCGG	BEAD-1C_FL	WT
ATAAGTGGGAACGATCCT	BEAD-1C_FL	WT
GACATACGTATCGCAATT	BEAD-1C_FL	WT
CGAGTAACCCAGATGAAT	BEAD-1C_FL	WT
ATTACAACCGCACTGCTT	BEAD-1C_FL	WT
ACGATTAACGCACGCCAC	BEAD-1C_FL	WT
ATCAGAGTGACGGTTCAT	BEAD-1C_FL	WT
GCCACGCAGATCGACAGT	BEAD-1C_FL	WT
ATTAGAGTCACAGATCAA	BEAD-1C_FL	WT
AACACAAGAGAACTCCAT	BEAD-1C_FL	WT
AAGAAAAAAGAACTTCTA	BEAD-1C_FL	WT
CTGGGGAGCCCGATAATC	BEAD-1C_FL	WT
ATCAGGAATGTGCCACTA	BEAD-1C_FL	WT
CCTGTGACGCTCAGTAAC	BEAD-1C_FL	WT
GTTATCCAAACCGACAAT	BEAD-1C_FL	WT
GATACCCTCAGAGCCATT	BEAD-1C_FL	WT
AATACAAGGGACCAACAT	BEAD-1C_FL	WT
GCAATCCACAATGAAATA	BEAD-1C_FL	WT
CGAGAAAACCCCAAGACC	BEAD-1C_FL	WT
GCTACACCTAAAGTAAAA	BEAD-1C_FL	WT
ATCACAATTGCCCCACAT	BEAD-1C_FL	WT
AGGAAAGTCAACGCACGT	BEAD-1C_FL	WT
AAAAACAACGTCCCGCCC	BEAD-1C_FL	WT
AAAACGACAGAACACCAA	BEAD-1C_FL	WT
ATAAGCACTGTCCTGCAA	BEAD-1C_FL	WT
ATTACCAACGTCCTACTC	BEAD-1C_FL	WT
CGAGTAACCCTAATCAAT	BEAD-1C_FL	WT
GGTAACCAAAAAGAGAAG	BEAD-1C_FL	WT
ATTACAGCCAACGATCCA	BEAD-1C_FL	WT
GCAACCCTCACAGGTAAT	BEAD-1C_FL	WT
ACGATTGCCACAGCACTA	BEAD-1C_FL	WT
AATATCGGCATTGATCCG	BEAD-1C_FL	WT
GTGAGACTAATGGCAATT	BEAD-1C_FL	WT
AGCACCACCGTACAGCAA	BEAD-1C_FL	WT
AATATTAGGGAACGACAG	BEAD-1C_FL	WT
ACTATAGATAGAGGGCGA	BEAD-1C_FL	WT
GAAACCCTTAGGGAGAGA	BEAD-1C_FL	WT
CCCGACAGGCTGACTACT	BEAD-1C_FL	WT
AGGAACGCAAGGGCCCCC	BEAD-1C_FL	WT
ATCACCGAGAAAGTACAA	BEAD-1C_FL	WT
GTGAACCTGATCGGAAGG	BEAD-1C_FL	WT
AACAAGGAAAAGGCGCCG	BEAD-1C_FL	WT
CCAGCGAGTCCAACCAGA	BEAD-1C_FL	WT
AACACAAAAGCGCGTCAA	BEAD-1C_FL	WT
AAGATAACAGTTCCGCAG	BEAD-1C_FL	WT
GCAACGCTCAACGTTATA	BEAD-1C_FL	WT
ACCATGACGGAACGACGC	BEAD-1C_FL	WT
ATAACTGGTACTGACCAA	BEAD-1C_FL	WT
ACTAAGGGCACCGACCGA	BEAD-1C_FL	WT
ATGAACGACAAGGTCCCC	BEAD-1C_FL	WT
CCTGCTACACATAGCATC	BEAD-1C_FL	WT
CACGGAACACATATTATA	BEAD-1C_FL	WT
ACCATTACCGACCCGCGC	BEAD-1C_FL	WT
ATAACAACTGATCAGCCC	BEAD-1C_FL	WT
AACAGCATAGAACATCCA	BEAD-1C_FL	WT
GAAATGCTGACGGTAAGC	BEAD-1C_FL	WT
AACAAAAATGCCCAACCT	BEAD-1C_FL	WT
AGAACGACGGAACACCCA	BEAD-1C_FL	WT
CTAGATATTCTGACAAAT	BEAD-1C_FL	WT
ATCACTAACGCGCCCCTT	BEAD-1C_FL	WT
CTAGCGAACCATATAAAC	gypsy_FL	WT
ACCAATAGTGATCAACCA	gypsy_FL	WT
ACTACAAGCGCCCGACCG	gypsy_FL	WT
ATAACCGGGATAGCCCCA	gypsy_FL	WT
ACAAGAGTAAAAGAGCAC	gypsy_FL	WT
CCCGCCATACAAATGAAG	gypsy_FL	WT
CTAGATACACCAACTATA	gypsy_FL	WT
CCCGCAAGACGGAAAAAA	gypsy_FL	WT
GGAAAACGTAGAGCCAAT	gypsy_FL	WT
AACAACGAGACAGAACAA	gypsy_FL	WT
AGCACCGCCAGGGTCCTA	gypsy_FL	WT
ATCAGGAGGGTGCTTCAA	gypsy_FL	WT
CACGTAAGACACAGAATG	gypsy_FL	WT
GTGAAACGCAACGCAAGC	gypsy_FL	WT
ATGACGGACACGGGTCCA	gypsy_FL	WT
GCAAAACAGATTGTCACA	gypsy_FL	WT
AGGATGGCCACGGTACTA	gypsy_FL	WT
AAAACGGAAAAGGGACAA	gypsy_FL	WT
ACAAATGGTAGCGTGCGG	gypsy_FL	WT
AGAACTGTCACAGCCCCT	gypsy_FL	WT
GAAAAGCAAACAGTAATT	gypsy_FL	WT
AAAATGGAAACGGAACGA	gypsy_FL	WT
CCAGTAAATCATAACACT	gypsy_FL	WT
ATCACCGATACCGTTCGC	gypsy_FL	WT
ATCAGGGATAAGGTACAA	gypsy_FL	WT
CTCGGTACCCCTAACATC	gypsy_FL	WT
ACTATCAAGGGGCCACAC	gypsy_FL	WT
CGCGTTATACGCAGAAGA	gypsy_FL	WT
ACAAACGAAAACGAACAC	gypsy_FL	WT
CGAGTGATACCCAGTACT	gypsy_FL	WT
ATGAATATGGAACACCAT	gypsy_FL	WT
ATAAATGCGAGAGCACGA	gypsy_FL	WT
CAAGCTACCCTTAAAATG	gypsy_FL	WT
GATAGTCTGAAGGAAACG	gypsy_FL	WT
ACAATGAGCGTTCAACGA	gypsy_FL	WT
ACAAACACTGACCGCCAT	gypsy_FL	WT
AACATAGAGACAGGCCAC	gypsy_FL	WT
ACCACAGCGAGTGCTCGC	gypsy_FL	WT
ATAATGAAAGAGCAACAA	gypsy_FL	WT
ATAACCGACAACGTCCTC	gypsy_FL	WT
AACAATGACACAGTCCTT	gypsy_FL	WT
ATAATAGTCACAGCACAG	gypsy_FL	WT
ATCATTACTGTCCTACGC	gypsy_FL	WT
ACCAATGCAACTGACCAT	gypsy_FL	WT
ACGAAAGAGAAAGGACGA	gypsy_FL	WT
AGGATAGCTACAGCACTA	gypsy_FL	WT
CAAGTGAATCATATAAAA	gypsy_FL	WT
CCTGTTACACATATAACT	gypsy_FL	WT
ATCATAATAGTGCCCCAG	gypsy_FL	WT
ATTAATGAAAGTGCCCAA	gypsy_FL	WT
ACGATTGAAAGAGGACAC	gypsy_FL	WT
AGAATCGATAATGCGCAT	gypsy_FL	WT
GAAACTCTCACCGTTACA	gypsy_FL	WT
ACCACAATTGTTCGTCTA	gypsy_FL	WT
ATTATTGCAATTGATCCA	gypsy_FL	WT
ATGACCAGGGATCAACCT	gypsy_FL	WT
CTGGGTAGACACACTATG	gypsy_FL	WT
ACAACGAGCGCCCTTCAC	gypsy_FL	WT
CATGCAATTCGCATCAAA	gypsy_FL	WT
GATACTCCAAGAGATACT	gypsy_FL	WT
ATGATTGCAAAAGTGCAA	gypsy_FL	WT
ATAACTAGAGTGCGGCTT	gypsy_FL	WT
ATAATAATCGGACAACAA	gypsy_FL	WT
ATCAATGCCAACGCTCAA	gypsy_FL	WT
GTTAGCCGAAGCGCAAAT	gypsy_FL	WT
CTTGGAATGCAAATTACT	gypsy_FL	WT
CGTGCCACGCTAACCATA	lambda-EXOB_FL	WT
AAGATCGCGAATGACCTC	lambda-EXOB_FL	WT
CAGGGAACGCGCATGAAT	lambda-EXOB_FL	WT
GAGATCCCTACGGCCAAC	lambda-EXOB_FL	WT
ACCAGGGAAACAGCACGG	lambda-EXOB_FL	WT
CTCGGCAACCCGACTACA	lambda-EXOB_FL	WT
ACCACGACAGCACAACTT	lambda-EXOB_FL	WT
GTAACCCATATTGAAAAA	lambda-EXOB_FL	WT
AACACTACGGCACTGCCA	lambda-EXOB_FL	WT
AGCAGAAACGATCCCCCA	lambda-EXOB_FL	WT
ACAAAAGACACGGCCCCT	lambda-EXOB_FL	WT
AAAAGGAAGGAACCGCAT	lambda-EXOB_FL	WT
AACAGAGTCAACGTCCAT	lambda-EXOB_FL	WT
CTAGCGAATCTCAACACG	lambda-EXOB_FL	WT
CCAGCCAGACGGAACAGG	lambda-EXOB_FL	WT
ACCACAACCGCCCCCCTC	lambda-EXOB_FL	WT
ACGATAGCCACAGCCCCT	lambda-EXOB_FL	WT
ATTAAGAAAGCGCAACAC	lambda-EXOB_FL	WT
AGTACAAATGCACTACTG	lambda-EXOB_FL	WT
CCGGCGACCCGAACGAAT	lambda-EXOB_FL	WT
GCTATACTGAATGGTAAG	lambda-EXOB_FL	WT
ATCAAAGCAAGAGAACAA	lambda-EXOB_FL	WT
CAAGCAACCCGCACTATT	lambda-EXOB_FL	WT
GCCATCCCAATCGTAACC	lambda-EXOB_FL	WT
AACAGGAAAGCCCCACGA	lambda-EXOB_FL	WT
CGAGCCAGACACACAAGG	lambda-EXOB_FL	WT
ATAAGCACGGACCGCCAA	lambda-EXOB_FL	WT
CCTGTCAGCCGAACGAGC	lambda-EXOB_FL	WT
CAGGAAACCCAGAACAAA	lambda-EXOB_FL	WT
AACATCGATAAAGACCAA	lambda-EXOB_FL	WT
GCCAACCCTAGGGAAACA	lambda-EXOB_FL	WT
GGCACACCTATCGCGACC	lambda-EXOB_FL	WT
ATCACCAGTGCACCCCGC	lambda-EXOB_FL	WT
CCAGCCAAGCACACCAAC	lambda-EXOB_FL	WT
CCAGTCAGACATAATACA	lambda-EXOB_FL	WT
CTAGAAACTCACAAGAAT	lambda-EXOB_FL	WT
CGAGATACTCCGAAAAGG	lambda-EXOB_FL	WT
GCTATGCTGACAGCCACA	lambda-EXOB_FL	WT
ATTACCACCGGACCGCAC	lambda-EXOB_FL	WT
ACGATCATAGTTCGTCGC	lambda-EXOB_FL	WT
ACCAACGTTAACGCACCT	lambda-EXOB_FL	WT
AATAACGCGAGAGTCCCT	lambda-EXOB_FL	WT
ACCATCGTGAGCGCTCGG	lambda-EXOB_FL	WT
CACGTGATCCCAAAGATA	lambda-EXOB_FL	WT
AACAATAAAGTACCACCG	lambda-EXOB_FL	WT
CTTGATAAACAAAATAAC	lambda-EXOB_FL	WT
CCAGGTATGCCAAGAAGT	lambda-EXOB_FL	WT
ACAATTGATAATGGGCTG	lambda-EXOB_FL	WT
ATCAATGAGATTGTTCTA	lambda-EXOB_FL	WT
GTCACTCGTATAGGCAAT	lambda-EXOB_FL	WT
CCGGCGAAGCCGAAAATA	lambda-EXOB_FL	WT
ACCAGGGCAAACGAGCCC	sIns1_FL	WT
AGCATAATAGACCCCCCA	sIns1_FL	WT
ACCAACAGTGCACGACGT	sIns1_FL	WT
AGAATGGTAAATGCTCAA	sIns1_FL	WT
CGTGTCAACCGCATAACC	sIns1_FL	WT
CTAGGAAACCAGAGTATA	sIns1_FL	WT
CTGGGTATGCACACCACA	sIns1_FL	WT
CCTGTCACCCTGAAAACT	sIns1_FL	WT
ATCATTGACACTGGACAA	sIns1_FL	WT
CACGAAATTCTCATTATC	sIns1_FL	WT
ACGACTAATGACCATCAT	sIns1_FL	WT
AGGAGTGGCACGGATCTC	sIns1_FL	WT
GACAACCATATCGTGACC	sIns1_FL	WT
ACAAAGACCGTTCAACTT	sIns1_FL	WT
CATGACAAACACACCAAA	sIns1_FL	WT
ACGACAAAAGGACTGCGA	sIns1_FL	WT
GTCAACCCCACTGGTAGC	sIns1_FL	WT
ACAAGTGTTATCGAGCTC	sIns1_FL	WT
ACCACGATAGGGCTACTA	sIns1_FL	WT
ACGACTGCTATAGTCCAC	sIns1_FL	WT
GTTACCCCTAAAGCCAAT	sIns1_FL	WT
CCAGAAAGGCAAATTATA	sIns1_FL	WT
CTGGCGACTCACATTACC	sIns1_FL	WT
GTGAACCTCACAGAGAAC	sIns1_FL	WT
AAGATAGATAAAGAGCAG	sIns1_FL	WT
CGTGCAAAACTAATAAAC	sIns1_FL	WT
GCAATTCCTAGGGGCAAA	sIns1_FL	WT
GTCATGCCGAAAGTTAAC	sIns1_FL	WT
AAAAACGTGATAGCTCAT	sIns1_FL	WT
GACAATCACAAAGATAAT	sIns1_FL	WT
CCAGAAATCCATAATATC	sIns1_FL	WT
ATCACAGTTATAGTGCAG	sIns1_FL	WT
AACAGAGTCAAGGACCTC	sIns1_FL	WT
AAAACCGGGACCGGGCTA	sIns1_FL	WT
GTGAACCGAATCGTCACT	sIns1_FL	WT
GCCAAACAAAACGCAAAG	sIns1_FL	WT
GACACACTCAGTGAAATA	sIns1_FL	WT
ATCAAAGTGAGAGCCCGC	sIns1_FL	WT
GTAACACTCATTGCTAGA	sIns1_FL	WT
AATAACACGGCACTCCAC	sIns1_FL	WT
ACAATAATAGGTCGACGC	sIns1_FL	WT
CACGGAAACCCTATCACC	sIns1_FL	WT
GCTATTCATATAGACAGA	sIns1_FL	WT
GACACGCCGAATGTCAGA	sIns1_FL	WT
AAGAACGTAACAGTCCTT	sIns1_FL	WT
GCTACCCACACCGGCAAT	sIns1_FL	WT
GCAAAACCAAACGCAACA	sIns1_FL	WT
ACCAAGGCAAAGGACCGT	sIns1_FL	WT
ACGAGTGTCATGGTGCAC	sIns1_FL	WT
AATACCATAGATCGGCCA	sIns1_FL	WT
CAAGCAAAACGGATCATT	sIns1_FL	WT
AAAAACGGGACCGGGCTA	sIns1_FL	WT
GAAAATCACACAGTCACT	sIns1_FL	WT
AATATGGTGAATGTTCCA	sIns1_FL	WT
GCCAAGCATATCGAGAGA	sIns1_FL	WT
GCCACGCATAGTGGAACA	sIns1_FL	WT
AATAACAAGGGGCTTCCC	sIns1_FL	WT
GACAAGCTCAAAGACATA	sIns1_FL	WT
AATAAAAAAGCTCTACTA	sIns1_FL	WT
CGAGGTAAGCTGAAGAAT	sIns1_FL	WT
CAAGTTACCCTAAAGAAA	sIns1_FL	WT
CTCGGGATCCGTATCATG	sIns1_FL	WT
GGCAAACTGAAAGTTATT	sIns1_FL	WT
GTCAAACCCAGCGACATC	sIns1_FL	WT
GCAATTCTAACTGTTAGA	sIns1_FL	WT
GGCACACAAATGGCTAAA	sIns1_FL	WT
ACAACCGTAAGCGCGCCT	sIns1_FL	WT
ACCACAGATAAGGAACGC	sIns1_FL	WT
CAAGACATTCGTACCAAA	sIns1_FL	WT
AAGATCACCGATCCACCA	sIns1_FL	WT
CCAGCGATACTTACGACC	sIns1_FL	WT
CAAGACAGTCGGATTAGA	sIns1_FL	WT
AACACAGCCACCGATCGA	sIns1_FL	WT
ACCATCGCGATCGACCTA	sIns1_FL	WT
CTGGGCACCCCAAGAAAA	sIns1_FL	WT
AAGAAAGTCACCGCGCTA	sIns1_FL	WT
AAAATAGGAACAGTACGA	sIns1_FL	WT
GGCATGCCTACAGGCACC	sIns1_FL	WT
GGAAAGCGTACAGTTATC	sIns1_FL	WT
ATAAGTGCCATAGACCTA	sIns1_FL	WT
GACAACCACATGGACAAG	sIns1_FL	WT
CATGTCATCCTGACTACA	sIns1_FL	WT
AGGAAGGTCACCGATCCT	sIns2_FL	WT
CAAGCCACACCTAAAAGA	sIns2_FL	WT
AAGATTGGCATCGGTCGG	sIns2_FL	WT
AGAAGAGCCAGGGATCAC	sIns2_FL	WT
GATACACGAACTGCCACT	sIns2_FL	WT
ACAAATAGGGAGCATCAG	sIns2_FL	WT
CCCGGTACACCAATGACC	sIns2_FL	WT
AGTAAGATGGTTCTACTG	sIns2_FL	WT
ACCAGAGATACCGCACCT	sIns2_FL	WT
CTTGTCAAACCCATAATG	sIns2_FL	WT
ACTAAAATTGGGCTCCCA	sIns2_FL	WT
AACATCACCGACCGACGT	sIns2_FL	WT
GTTACGCCCACTGATACC	sIns2_FL	WT
ACAACCGAAAACGTGCAG	sIns2_FL	WT
CAGGAAACCCTAATAAGC	sIns2_FL	WT
AAAACCGTAACTGAGCCT	sIns2_FL	WT
ACAAGAGTTACAGGACCC	sIns2_FL	WT
ATCAACGCAACCGCTCCC	sIns2_FL	WT
AGCATCAGTGCGCCACGT	sIns2_FL	WT
ATAACGACAGGACTACGA	sIns2_FL	WT
AAAATGGTTATTGCGCAA	sIns2_FL	WT
AAAAGCGCCAAAGACCGC	sIns2_FL	WT
CACGCAAACCTCAGCAAC	sIns2_FL	WT
GTCACCCGTATAGATAAT	sIns2_FL	WT
AGGAGTAAGGAACACCAG	sIns2_FL	WT
CAAGTAACCCCAAACACA	sIns2_FL	WT
CTAGATAAACTAACAAGG	sIns2_FL	WT
GCCAACCTAAGCGTTAGA	sIns2_FL	WT
CATGTAACCCTGAATAAA	sIns2_FL	WT
ATCATAATTGTCCGCCTG	sIns2_FL	WT
CAAGAAAAGCTAATTATA	sIns2_FL	WT
CTTGGCATTCTAAGTAAC	sIns2_FL	WT
GCCACACCCACAGGAACA	sIns2_FL	WT
AACACAGATAACGTTCCA	sIns2_FL	WT
CGAGCAAAACAAAATAAT	sIns2_FL	WT
GCGACGCCCAATGTAATA	sIns2_FL	WT
AGCAAAGTCATAGCCCTC	sIns2_FL	WT
AGAAGCGTCACTGGCCCC	sIns2_FL	WT
GATATACAAACTGAAAAA	sIns2_FL	WT
CGGGCCAATCGAACCAAT	sIns2_FL	WT
ACCACGGTCAGGGTGCGA	sIns2_FL	WT
AGTATTGACACCGCCCTC	sIns2_FL	WT
GTTACCCAAAGTGTAAAA	sIns2_FL	WT
ACGAGGGCGAACGGCCAG	sIns2_FL	WT
ACGACTATCGCGCAGCCA	sIns2_FL	WT
CTTGCCAGCCCGAATACT	sIns2_FL	WT
CTTGATATTCCAACCAAT	sIns2_FL	WT
AACACCGCCACCGCACAA	sIns2_FL	WT
CTTGGGAGCCGTACCACC	sIns2_FL	WT
GAGAATCCTAACGGAAGA	sIns2_FL	WT
AAAATCACTGGCCACCAG	sIns2_FL	WT
CCGGCTAAGCTCAAGAAT	sIns2_FL	WT
AAAAGAACAGCCCATCCC	sIns2_FL	WT
GTTACACATATCGACAAG	sIns2_FL	WT
GCAACCCTCACTGCAATA	sIns2_FL	WT
GCAATCCGCAATGGCACA	sIns2_FL	WT
ACGAAAAATGCTCTTCAC	sIns2_FL	WT
GCAAACCCCACGGATATT	sIns2_FL	WT
ATCATAAATGAGCTACCG	sIns2_FL	WT
AGCATAATAGACCTCCTA	sIns2_FL	WT
AAAAACGGGAATGTGCTT	sIns2_FL	WT
GCCAACCTTAACGTGAGC	sIns2_FL	WT
ACTAATAAAGACCTCCGT	sIns2_FL	WT
ACAAGAATCGCACACCAG	sIns2_FL	WT
CACGGTATACCTAAAAGG	sIns2_FL	WT
GTAAAGCATAGGGGAAAC	sIns2_FL	WT
ACAATGGCCAGAGAGCGA	sIns2_FL	WT
CCCGACAGGCTTACAACA	sIns2_FL	WT
CACGGCAGCCGAAGAACA	sIns2_FL	WT
ACCACCAGCGCTCCACAT	sIns2_FL	WT
AAAACGACAGGACTACGA	sIns2_FL	WT
AAAAAAACAGGTCTACGC	sIns2_FL	WT
ACCAGCGGAACCGAACGT	sIns2_FL	WT
ATTACAATGGGACGCCAC	sIns2_FL	WT
GGCAATCTGACGGCAACA	UASrpg_FL	WT
CCCGGGATTCCAACAATC	UASrpg_FL	WT
ATCACCAGAGTACAACAT	UASrpg_FL	WT
GACATTCCGACAGTCATT	UASrpg_FL	WT
ACAAATATTGCGCTTCAG	UASrpg_FL	WT
GATAACCAAAAAGTTATA	UASrpg_FL	WT
AAGACAAGAGCACTGCCA	UASrpg_FL	WT
GCTATCCCCACGGTAACT	UASrpg_FL	WT
GATAAGCCGATCGACAGA	UASrpg_FL	WT
CCCGTAATCCGCAACATT	UASrpg_FL	WT
CCTGATACACAAAATAGT	UASrpg_FL	WT
CTCGGCAGCCTAAGCACG	UASrpg_FL	WT
CCAGCTAAACCAAAAACC	UASrpg_FL	WT
GAAAAACTTATGGACAAA	UASrpg_FL	WT
CGCGTAACCCAGACCAAA	UASrpg_FL	WT
GCCACTCTCAACGGGAAC	UASrpg_FL	WT
CCCGGCATTCGAAACACT	UASrpg_FL	WT
CATGATAGTCACACTAGC	UASrpg_FL	WT
GACAAGCAGATAGTAAAA	UASrpg_FL	WT
GCAACACTAAATGTGACT	UASrpg_FL	WT
GTCATCCTTAAAGGCACT	UASrpg_FL	WT
AATATAGAAAAAGATCCA	UASrpg_FL	WT
GAAAAACGGATGGAGAAG	UASrpg_FL	WT
GAAACTCAAATTGAAAAG	UASrpg_FL	WT
AGAATAGGAAAAGACCTA	UASrpg_FL	WT
ACTAGTGCGAGAGAACAT	UASrpg_FL	WT
ACGAAAACCGTGCTACCA	UASrpg_FL	WT
ACGATCGATACGGTACAG	UASrpg_FL	WT
CCCGAAAAACGAAAAAGA	UASrpg_FL	WT
CCTGGCATCCCTAATACC	UASrpg_FL	WT
CGCGCCAAACGAATTACT	UASrpg_FL	WT
AGTACAACCGTGCTACGA	UASrpg_FL	WT
GGTATGCGGACCGAAACG	UASrpg_FL	WT
AGGACTAATGGACGCCAA	UASrpg_FL	WT
AGCAATGATACAGTTCAA	UASrpg_FL	WT
AGTAACGCCAAAGATCTA	UASrpg_FL	WT
ACTAAAACGGGGCCGCAC	UASrpg_FL	WT
ACAAAGGACAGAGTCCAC	UASrpg_FL	WT
AATAATATAGAGCCACAG	UASrpg_FL	WT
GGTATACTAAATGTTAGA	UASrpg_FL	WT
ATGAGGGCGACCGACCAG	UASrpg_FL	WT
ACAAGCACAGACCATCCC	UASrpg_FL	WT
CTGGCAAGACCCAGCACG	UASrpg_FL	WT
CTAGAAACCCGTATGACT	UASrpg_FL	WT
CAAGTCAGGCTCAACAGA	UASrpg_FL	WT
ATCATCGACACAGTACCT	UASrpg_FL	WT
GCCACACACACTGACAAT	UASrpg_FL	WT
GCGAATCCCAATGAAAGA	UASrpg_FL	WT
AAAACCATAGCCCACCCA	UASrpg_FL	WT
AGCAACGCTAACGATCAT	UASrpg_FL	WT
AGAACCGCCAAGGACCCA	UASrpg_FL	WT
GACACACTCAAAGCAATT	UASrpg_FL	WT
GGTACTCTTAACGGAACT	UASrpg_FL	WT
CCCGGCATCCCCAATAAA	UASrpg_FL	WT
CATGTGATGCCTAATAGC	UASrpg_FL	WT
ACAAACGACACTGCTCCG	UASrpg_FL	WT
ATAAGCGTAAACGCACGA	UASrpg_FL	WT
ACTAATAGTGACCTTCAA	UASrpg_FL	WT
ACCATAGCAACTGTACCG	UASrpg_FL	WT
ACAAGCATAGTACGACAA	UASrpg_FL	WT
GGAAACCGTAACGTCAGG	UASrpg_FL	WT
GACATGCACAGCGCTAGT	UASrpg_FL	WT
AATAAAAGCGACCGACGT	UASrpg_FL	WT
GACATACTGACAGTCAAG	UASrpg_FL	WT
CCCGTAAAGCCCACGACC	UASrpg_FL	WT
ACCAACAGGGACCTACAA	UASrpg_FL	WT
AGCAAGAGAGCCCCACCG	UASrpg_FL	WT
ATAATAGGAAAGGACCCC	UASrpg_FL	WT
ACCAAGGCAAAAGATCCA	UASrpg_FL	WT
GCGAGCCATACTGAAATT	UASrpg_FL	WT
AAAAATGAAAAGGTGCCT	UASrpg_FL	WT
AAGAAAGTGAGTGCACGC	UASrpg_FL	WT
GTGATACGAACTGTAAGA	UASrpg_FL	WT
GCGAACCAAATAGACAGC	UASrpg_FL	WT
GACAGCCCAAGTGATAGC	UASrpg_FL	WT
ACTATAGAAAAGGAGCGA	UASrpg_FL	WT
