barcode	enhancer
ATAACCGCTGAAAATGCA	none
CGGCCAACGAATGGAAGA	35S
CACCCAACTACGGCCAAC	35S
CTTCCTATCACTGACAAA	35S
CCGCTTATCAAAGCCACT	35S
AATATTGGCGCTAACGTC	none
ACCATTGCAGAAAGCGCT	none
CGCCACACAAGGGTTATA	35S
ACAACAGACGAAAATGAT	none
CAGCGTACTACAGAAAGA	35S
AAAAAAGTTGTTATAGCC	none
AACAAAGCAGTCACCGCA	none
CATCCAAACATTGTTATA	35S
ACTACCGGCGCCATGGGC	none
CGACTCAACACCGAAATA	35S
CCCCATACGATCGTGATA	35S
CTACCAATCACCGATAAC	35S
ACCATGGCTGACACCGAG	none
ATCAGAGTTGTAACCGAT	none
CCCCCGATAAAAGTGAGC	35S
ACCACAGATGGCACAGAT	none
CTACATACCACAGGCAGT	35S
ACTATGGGGGTCACGGGA	none
CCCCAGATAAAGGACAGC	35S
CCGCTAAACACCGCCATA	35S
AATACGGAAGTAAAAGTT	none
CAGCTCAGAATTGACATA	35S
AAAAACGAAGCGACCGCA	none
CATCGTAAGAACGTAATA	35S
CCTCGCAAAAATGATACA	35S
CACCTAACAAAAGTTACC	35S
CCTCAAATGATGGAGAGA	35S
CAGCTTAAAATTGGAATT	35S
AGCATAGAAGCCAATGCT	none
CCTCTCATAAGCGTCAGA	35S
AAAACAGACGTAAAAGTT	none
ACTATAGTAGAGAACGTA	none
AGGACCGAAGTAATGGAT	none
ACCAAGGGTGCCATAGCA	none
CAACATACTACAGTAAAA	35S
AATAACGACGAGAGGGAA	none
ATAAGGGTAGGAATCGGC	none
CCACATATCAAGGTTATA	35S
ACGAGCGACGGTAGTGTC	none
AACAATGATGTTAAGGAC	none
CAACCTACTACGGCCAAC	35S
ACAACCGCCGCGAGAGAC	none
ATAAACGCCGCCAAAGGC	none
CTCCAGATAAACGGGAAA	35S
CTCCGAACCAGAGAAAAT	35S
ACTAACGCGGTAAAAGCA	none
CCCCGGACTACGGCAATG	35S
ATGAACGTTGTAATAGTC	none
CCTCGCATTATTGCGACT	35S
