barcode	enhancer
ATAACCGCTGAAAATGCA	none_none
CGGCCAACGAATGGAAGA	35S_none
CACCCAACTACGGCCAAC	35S_none
CTTCCTATCACTGACAAA	35S_none
CCGCTTATCAAAGCCACT	35S_none
AATATTGGCGCTAACGTC	none_none
ACCATTGCAGAAAGCGCT	none_none
CGCCACACAAGGGTTATA	35S_none
ACAACAGACGAAAATGAT	none_none
CAGCGTACTACAGAAAGA	35S_none
AAAAAAGTTGTTATAGCC	none_none
AACAAAGCAGTCACCGCA	none_none
CATCCAAACATTGTTATA	35S_none
ACTACCGGCGCCATGGGC	none_none
CGACTCAACACCGAAATA	35S_none
CCCCATACGATCGTGATA	35S_none
CTACCAATCACCGATAAC	35S_none
ACCATGGCTGACACCGAG	none_none
ATCAGAGTTGTAACCGAT	none_none
CCCCCGATAAAAGTGAGC	35S_none
ACCACAGATGGCACAGAT	none_none
CTACATACCACAGGCAGT	35S_none
ACTATGGGGGTCACGGGA	none_none
CCCCAGATAAAGGACAGC	35S_none
CCGCTAAACACCGCCATA	35S_none
AATACGGAAGTAAAAGTT	none_none
CAGCTCAGAATTGACATA	35S_none
AAAAACGAAGCGACCGCA	none_none
CATCGTAAGAACGTAATA	35S_none
CCTCGCAAAAATGATACA	35S_none
CACCTAACAAAAGTTACC	35S_none
CCTCAAATGATGGAGAGA	35S_none
CAGCTTAAAATTGGAATT	35S_none
AGCATAGAAGCCAATGCT	none_none
CCTCTCATAAGCGTCAGA	35S_none
AAAACAGACGTAAAAGTT	none_none
ACTATAGTAGAGAACGTA	none_none
AGGACCGAAGTAATGGAT	none_none
ACCAAGGGTGCCATAGCA	none_none
CAACATACTACAGTAAAA	35S_none
AATAACGACGAGAGGGAA	none_none
ATAAGGGTAGGAATCGGC	none_none
CCACATATCAAGGTTATA	35S_none
ACGAGCGACGGTAGTGTC	none_none
AACAATGATGTTAAGGAC	none_none
CAACCTACTACGGCCAAC	35S_none
ACAACCGCCGCGAGAGAC	none_none
ATAAACGCCGCCAAAGGC	none_none
CTCCAGATAAACGGGAAA	35S_none
CTCCGAACCAGAGAAAAT	35S_none
ACTAACGCGGTAAAAGCA	none_none
CCCCGGACTACGGCAATG	35S_none
ATGAACGTTGTAATAGTC	none_none
CCTCGCATTATTGCGACT	35S_none
AACCAGGGGCTTAGAAGC	none_Cab-1
AACCACGAACGGACAACC	none_Cab-1
CATACTCCAGAAAACAAG	35S_Cab-1
ATAGACCACACACATAAT	none_AB80
ATTGGAAAAGATGGTATT	35S_AB80
ACGGCGAAAGCTGGAAGG	35S_AB80
ACCGTACTAAATCATACA	none_AB80
ACCCAAGGCCTGAACAGA	none_Cab-1
AACGCAACAGAAGATAAA	35S_AB80
CGAACGCATGGTATTACT	35S_Cab-1
ACTCTAGAGCGCATAAGA	none_Cab-1
ACCGCTCACAACCATATA	none_AB80
AGGGCGAACGAGGAAACC	35S_AB80
CAGAAACTAGCTATCACG	35S_Cab-1
ACTGACACTGTAGCTACA	35S_AB80
AGCCAGGGCCCCAGCAGT	none_Cab-1
CGTAGACTAGATACCAGC	35S_Cab-1
ACCGACCTAAGTCAAAAC	none_AB80
ATGGCCCTTAAACTAAAT	none_AB80
AACCCGGTGCGCACAAAC	none_Cab-1
CAAACCCTAGCCACAATT	35S_Cab-1
AACCCGGGGCGCACAAAC	none_Cab-1
ACGGCTCAAACTCTCATT	none_AB80
CGCAATCTAGCCAGAAGG	35S_Cab-1
ATAGAAAACGGTGTCACA	35S_AB80
ACTGTTATCGTTGACACC	35S_AB80
CTAACTCACGTTAGAAAA	35S_Cab-1
AACCAAGCCCCCACTAGC	none_Cab-1
AGTCTGGGTCGCAAGAAA	none_Cab-1
AAACCAGTCCAGATAACA	none_Cab-1
CTTAAGCGTGTCAAGACA	35S_Cab-1
ACGCTTGGGCATACGAAT	none_Cab-1
AAACGTGCCCCTAGCAGG	none_Cab-1
ATGGGACCGAGTCCCAAT	none_AB80
ATTGTTCTTAAGCAAAGG	none_AB80
ACTGTTAAAGGGGCGACA	35S_AB80
AACGCTCATACACACATA	none_AB80
ATTCTGGATCGTAGAAAT	none_Cab-1
AGTCCAGATCACAAGAGG	none_Cab-1
AACGACCTTAATCAAAGT	none_AB80
ACCGTCACCGAAGAAACA	35S_AB80
AGCCTAGACCCAATCAGA	none_Cab-1
AAAGTACTAAGTCGCATA	none_AB80
ACGGCGAGAGCAGGCAAC	35S_AB80
ATCGTAAGCGACGACAAC	35S_AB80
CCAACCCTAGACAGGATA	35S_Cab-1
AGTGTTCCGACTCATAAC	none_AB80
ACTGAGAAGGGAGCGAGC	35S_AB80
CCCAAGCCAGATATCAAA	35S_Cab-1
ATCGCGCGTATCCTCACT	none_AB80
CCCACTCTAGACAATATT	35S_Cab-1
AACGATAGCGAAGTCAAG	35S_AB80
