barcode	insulator
GCCAATCTTAAGGTAAGA	BEAD-1C
CAAGACACTCGTAATAAA	BEAD-1C
GTAAAGCGAACGGACAGA	BEAD-1C
CACGATAATCAGACAATC	BEAD-1C
GTTAAACCTAACGGTACT	BEAD-1C
GGCAGCCAAATAGAAAGA	BEAD-1C
CACGATAAGCAAAGAAAA	BEAD-1C
GCTAATCTAAGGGCCATA	BEAD-1C
GCGACACATAGCGGCATG	BEAD-1C
CTCGGAAATCTAAATATG	BEAD-1C
CAAGAAATACAAACAAAA	BEAD-1C
CACGAAATACATACCAGG	BEAD-1C
GGAAAACTCAGCGTCAAC	BEAD-1C
GACAGCCACATGGACACA	BEAD-1C
GCCAAGCACAAAGCCACA	BEAD-1C
GCCATGCTTAAAGCCAAC	BEAD-1C
GACATACATATGGCTAAA	BEAD-1C
CCGGGAAAGCCAAAGAAT	BEAD-1C
CGAGAAATCCCTAACAAA	BEAD-1C
CCGGCTACGCATACGATC	BEAD-1C
CTCGAAAGCCTTATCAAG	BEAD-1C
CCAGATAAACCGAACACT	BEAD-1C
CCGGGCACCCGGACAACC	BEAD-1C
CGTGAGATCCCAATAAAA	BEAD-1C
GTGATACGCAAGGTTATA	BEAD-1C
CCAGTCATTCTGAACAAA	BEAD-1C
CCCGACAACCTTATCAAA	BEAD-1C
CATGCAATCCCTACTAAA	BEAD-1C
CCCGACACACATAAAAGT	BEAD-1C
CACGTCATTCAAAGAATG	BEAD-1C
GTTAACCCAAATGTCATA	BEAD-1C
GTTACGCTAAGAGAAATT	BEAD-1C
CCTGCCATGCATAATACC	BEAD-1C
CATGTAATACTAAAAAGA	BEAD-1C
CTAGTTACCCAAATAACA	BEAD-1C
CTTGGAATACCGACCAAA	BEAD-1C
GAAAGACTTATCGTTATA	BEAD-1C
CGGGTTATTCTCATAAAA	BEAD-1C
CCCGCCAACCAAAATAAA	BEAD-1C
CCCGCGACTCTTATTAAT	BEAD-1C
CCAGCTAGACGCAGGATA	BEAD-1C
CCAGCCATACTTATGACA	BEAD-1C
CAGGCTATTCTTAGTATG	BEAD-1C
CACGCAAATCGAAATAAC	BEAD-1C
GCAACGCAAATCGCTAAA	BEAD-1C
CATGGCAATCAAAAAATT	BEAD-1C
CACGTTATACCAAGAAAG	BEAD-1C
GCCATGCAAATTGACACT	BEAD-1C
GCTATGCCTAATGGTACA	BEAD-1C
CACGACATCCTCACTACA	BEAD-1C
GATACCCAAACAGCCACC	BEAD-1C
GTAAGACAAACTGTAAAC	BEAD-1C
CCAGGAATACAAATAAAC	BEAD-1C
CCAGTAATCCATATTAAC	BEAD-1C
CACGCCACGCCCATAAGC	BEAD-1C
GGTAAACTGAACGACAAT	BEAD-1C
GCTACCCAAAACGGCATC	BEAD-1C
GTGATGCCGAGCGAAACT	BEAD-1C
CTAGTGAGTCAAAACACA	BEAD-1C
GCTAATCACAATGCCAAA	BEAD-1C
GATACACCAAACGGAAAG	BEAD-1C
CTGGAAAACCATAATAAT	BEAD-1C
CTAGTAAAACTGAGAACT	BEAD-1C
GCAACACCCAAAGCTACT	BEAD-1C
CGGGTGATTCTGACCAGG	BEAD-1C
CCAGAAAACCTCAAAAAT	BEAD-1C
CTGGTAAGACAAAATAAA	BEAD-1C
GGCACTCTCAACGCTACG	BEAD-1C
CCAGTCAGCCACACTAAC	BEAD-1C
GAAATTCTGAGCGCGAAT	BEAD-1C
CCCGAAATGCTAAACACT	BEAD-1C
CTCGTCATCCTGATTATG	BEAD-1C
CTCGAAACACTCACAATT	BEAD-1C
CCTGGCAGCCCTATGATC	BEAD-1C
CGTGAAAAACGAACGACT	BEAD-1C
CCAGCTACACCAAGTAAT	BEAD-1C
CAGGTAAACCAAAGCAAA	BEAD-1C
GTAAAGCCAAGCGATAAA	BEAD-1C
GCAAATCACATAGAAACA	BEAD-1C
CAAGATATCCGTAACATT	BEAD-1C
CCTGTAACCCCGAGAAAC	BEAD-1C
GCCATCCATAGAGCAAAT	BEAD-1C
CGGGAGAAGCGAAAAAAC	BEAD-1C
CAAGGAACTCCTAAGATA	BEAD-1C
CGCGGAATACCGACCAAC	BEAD-1C
CGAGATACACTAACCATG	BEAD-1C
CTCGCCACTCGCAAAACT	BEAD-1C
GTCATCCTCAATGACAGA	BEAD-1C
CCGGCGATGCTTACAACC	BEAD-1C
GTGAGACTTAGGGCAAAA	BEAD-1C
GCGATTCGTACTGACACA	BEAD-1C
CAAGGCAGGCTCAGAAAC	BEAD-1C
CATGAAAAACAAACGAAC	BEAD-1C
CCTGCAAGGCTCACTAAA	BEAD-1C
GAAACTCCTACAGAGAGG	BEAD-1C
CCTGCGAATCACACAATT	BEAD-1C
GATAGCCTTAATGTGAGG	BEAD-1C
CAAGTCATTCAAACGAAT	BEAD-1C
CATGCAAGCCCAAATATC	BEAD-1C
GACAACCAGAAAGAAACA	BEAD-1C
GCTACTCCCAAAGTAAAA	BEAD-1C
GGAACTCTCAGTGATATC	BEAD-1C
GCCAACCAGACAGCAATT	BEAD-1C
CCCGGTACACTAAGCAGT	BEAD-1C
CGCGACATACAGACTAAT	BEAD-1C
CCGGTGACTCGCACCATC	BEAD-1C
GGAAAACCTAACGCAAAC	BEAD-1C
CTCGTTAGACCCACTATT	BEAD-1C
GAAAATCTGACTGCCACC	BEAD-1C
GGAACACCGAGTGACATT	BEAD-1C
GCAACACACAAGGTAAGT	BEAD-1C
CTTGAAAGTCAAATAAAA	BEAD-1C
CAAGCTATCCACAGAAAT	BEAD-1C
CTCGTAACACATAAAAAT	BEAD-1C
GATATACAAAGAGTAATC	BEAD-1C
GGAACACGTACAGCCACA	BEAD-1C
GCCACTCATAAGGGAAAC	BEAD-1C
CAAGATACACTAAGCATA	BEAD-1C
CCAGACAACCTCACCAAC	BEAD-1C
GGAAATCAAATCGTGATA	BEAD-1C
CCAGCCAGTCACATTATC	BEAD-1C
CCTGAAAACCTAATCAAT	BEAD-1C
CTAGATAACCTGAGCAAA	BEAD-1C
GCGACCCTCAAGGAAACT	BEAD-1C
CTTGCAACTCATAGCAAA	BEAD-1C
GCAATCCTTAGTGCCAAT	BEAD-1C
CATGAAAGACATATTATA	BEAD-1C
GGTAACCTGAACGGTAGC	BEAD-1C
GCTAACCTCATTGATAAA	BEAD-1C
GTCATTCCAAAAGAAAAT	BEAD-1C
GACACCCACATCGGCAGA	BEAD-1C
GCTAACCCCAAAGAAAAA	BEAD-1C
GTAATCCTTACCGCAAAT	BEAD-1C
GCAACTCCGAACGACAGA	BEAD-1C
CGCGGAAATCCAAGAATA	BEAD-1C
CGCGGAACTCGAACCACG	BEAD-1C
CGGGACATACCCAATACC	BEAD-1C
GCAATTCATACCGAGAAT	BEAD-1C
CGTGACATCCTTACCATT	BEAD-1C
CTAGACACACAGATGATA	BEAD-1C
GCGAACCCGATAGCTACA	BEAD-1C
GTAATACTCACTGCAATG	BEAD-1C
GTAAAACTCAATGGCACA	BEAD-1C
GCTATGCAAAGCGGGAAT	BEAD-1C
GTAACACAGAAAGCCATC	BEAD-1C
CACGTTAAACCAATTAAA	BEAD-1C
CCAGCAAGTCCGATAACT	BEAD-1C
GCAATCCTAACCGGCAGA	BEAD-1C
GCCAACCCCACAGTTACT	BEAD-1C
CCCGGCAAACTTAACAGA	BEAD-1C
GAGATACTGATCGAAAAA	BEAD-1C
CTCGCTAACCCAAATAAT	BEAD-1C
GATAAACTCACAGTCAAC	gypsy
CCTGGGAATCAGAGCACC	gypsy
GCCATGCGTATTGTAAGT	gypsy
GTTATTCGTACAGATACA	gypsy
GGAACTCGCAAAGCCAAG	gypsy
GCTAGACGCAACGCCAGT	gypsy
GCTAGACTAAGAGCCAAC	gypsy
CTTGTCAACCGCAAAATG	gypsy
CAAGTCAGACATACTATC	gypsy
GCAAGCCATACCGGTAAT	gypsy
CGAGAGATACCGATTAAG	gypsy
CATGTGACTCATAATACA	gypsy
CGGGCAACTCGTACAACA	gypsy
CATGCCACCCGAATCAAA	gypsy
GAAATCCGGAACGATATA	gypsy
GAGAGACATATAGTCATC	gypsy
CGCGCAAACCGCAGCAAT	gypsy
GACAATCTGATAGTTATC	gypsy
CGTGCTACCCCAAATAAG	gypsy
CATGTTAAGCAAACTAAG	gypsy
GTTAGACTGACGGGTAGT	gypsy
GACATCCCCAAGGGCACA	gypsy
GACAAGCCAATCGACAGT	gypsy
CCGGTCACCCCCACCATT	gypsy
CCTGCCAACCAAATTATA	gypsy
CACGCAAAACAGACAAAA	gypsy
GTAATTCGAAACGTAAAA	gypsy
CAGGTGATTCTAAAAACG	gypsy
GCTAATCCCAACGTCAAA	gypsy
GTTAGTCGAACCGTCAAA	gypsy
CCAGAGAATCATACCACT	gypsy
GCAAATCTCAGTGGAATC	gypsy
CCAGTAACACCGATCATC	gypsy
CCAGATAATCCAAAAAAG	gypsy
GTGATTCGAATGGCTAAC	gypsy
CTGGCAAAGCCTAAGACC	gypsy
GTAAGTCTAAAAGGGAAG	gypsy
CAAGTTATTCGAAATAAA	gypsy
CTTGTTAGCCTGAAAATC	gypsy
GTAACTCTAACTGTGACT	gypsy
CACGTGATCCTCAATATA	gypsy
GCTAAACCTATAGGCATT	gypsy
CAAGACATACAAATAAAT	gypsy
GAGAATCTCATTGCAACT	gypsy
GCGAAACATACAGAAATA	gypsy
CTTGGTAATCGGATCACA	gypsy
CTCGGAATACTAAGAACT	gypsy
GGAACACAGAAGGATATG	gypsy
CACGCAACGCGCATCATT	gypsy
GGAACGCTCATTGATATC	gypsy
GCAATACCGAAGGTCAAT	gypsy
CAAGTAACACCAAATAAG	gypsy
GATATTCACAAGGCCAAT	gypsy
CTAGTAACTCGAACAATT	gypsy
CGTGGAAGTCCCACGACA	gypsy
CTTGGGAGCCAAAACAAC	gypsy
GACAGACTTACTGTAAGC	gypsy
GATATACTGAATGAGATT	gypsy
GTTATACGCACCGCTATA	gypsy
GTCAAACAAATAGCAATA	gypsy
GCGAGCCCCATGGTTATA	gypsy
CTCGTAACGCTAAAAATC	gypsy
CCAGCCATTCATAGGATT	gypsy
CGCGAAACGCGGATAAAG	gypsy
CTTGTTACGCAAAAGATC	gypsy
GAAACTCAGACTGAAACG	gypsy
CGTGGAAATCTTAATAGT	gypsy
GCAACGCCAATTGTTAAC	gypsy
GCAAAACAAAATGATAAG	gypsy
CATGCAAGTCGAAGTACG	gypsy
CAAGGGAACCCAAGTAAG	gypsy
CGTGTCATACAAACTACA	gypsy
GACACACACAATGGCAAC	gypsy
GAAACACCTATAGCGAAA	gypsy
CGCGTAACCCAAACGAAG	gypsy
CAAGCGATTCATATAAGA	gypsy
CTAGAAATCCCCATAACG	gypsy
GACAACCACAAAGCCATC	gypsy
CAAGTTACCCATATCACT	gypsy
CCGGACATACACACGACC	gypsy
GAAACCCAAAATGCAAAT	gypsy
GTGAGACGCATTGGTACA	gypsy
CCGGCTAGACCAATAAAA	gypsy
CTGGTCAAACGCATGACT	gypsy
CAAGACAGCCCAACAACA	gypsy
CAGGATAGTCCAATAATT	gypsy
GCTATTCCAAAAGCGACG	gypsy
CGGGTTACACGCATTAGC	gypsy
GCGACCCGTAGAGACACC	gypsy
CTAGACACCCTCAGAATT	gypsy
GCCAACCGTAACGCGACC	gypsy
GTTACCCTAATAGAAACA	gypsy
CTAGTTAGGCCCATGAAC	gypsy
GCCATCCCCACTGGTACA	gypsy
GACACCCCTAAAGTAAAA	gypsy
CATGCAATACCCATGAAA	gypsy
GAGACGCTTACAGAGAAA	gypsy
CAAGTCACCCTAAAAAAC	gypsy
GCGAACCCCAATGAAACG	gypsy
GAGATACAAACAGCGAGT	gypsy
CATGATAAGCATATCAAA	gypsy
GGCACGCAAATTGGTACA	gypsy
CACGTAACGCTTATCATC	gypsy
CCTGCAAACCGGAAGAAT	gypsy
GACAGACAGAGTGCTAAG	gypsy
GTAATCCTCACGGATAGG	gypsy
CCTGACAACCTCAAAATA	gypsy
CCCGCAATTCTAAAAACC	gypsy
GCTAGCCATAATGGTACA	gypsy
CGGGAAACTCACAAAAAC	gypsy
GCAAACCTCACCGTCACC	gypsy
CAGGGAAACCATACGACG	gypsy
GTCAGACGCACTGTCATA	gypsy
CTTGCGAGGCGCATAATA	gypsy
CTTGACAATCGCACTATC	gypsy
GCCAGCCCCACTGACACA	gypsy
CGCGGAAATCAGACTATA	lambda-EXOB
CATGCCAGTCATATAAGC	lambda-EXOB
CCAGCTACACCCAGAATA	lambda-EXOB
GATAGTCCAATAGCTAAA	lambda-EXOB
GCAAAACACACTGTGAGA	lambda-EXOB
CATGGCAGTCCCATCATC	lambda-EXOB
GCTATTCACACCGCAAAT	lambda-EXOB
GCTAGCCTAATGGGCACC	lambda-EXOB
GGCATACCTAACGGCACA	lambda-EXOB
GAAATACGTATAGGAAGC	lambda-EXOB
CATGCAACTCAGAACATC	lambda-EXOB
CCAGCTAAGCATAACAGA	lambda-EXOB
GCAATTCTAAATGGGACA	lambda-EXOB
GTCATGCAAAACGCTAAA	lambda-EXOB
CACGCCAGCCCTAAGAAC	lambda-EXOB
GTTATGCGAACAGACAAC	lambda-EXOB
GCAAACCTAAAAGTAACT	lambda-EXOB
GCGAAACTAACGGACAGA	lambda-EXOB
CGGGGGATACAGAAAATA	lambda-EXOB
CCAGGCACACACATCAGA	lambda-EXOB
GAGAACCAGACTGGTAAG	lambda-EXOB
GCAAAACGAATAGAAAAG	lambda-EXOB
GATAACCATACAGTGAAC	lambda-EXOB
CCAGACACTCATACCAAC	lambda-EXOB
CACGATAACCCCATTATT	lambda-EXOB
CTGGCTAGTCGGAATATT	lambda-EXOB
CGAGTCAAGCAAAAAACT	lambda-EXOB
CGAGCAAGGCACAGCAGC	lambda-EXOB
CCGGATAAGCTCAGTAAA	lambda-EXOB
GCTACACGGAATGCGAGA	lambda-EXOB
GCAATTCGTAAGGTTAAC	lambda-EXOB
GCCAAGCGTAAAGCCACG	lambda-EXOB
GAAAATCCAATAGTTAAC	lambda-EXOB
GCTAATCTAAACGAAACT	lambda-EXOB
GACAAACACATGGTAAAT	lambda-EXOB
CAAGATATTCCAATTAGC	lambda-EXOB
CCAGCTAATCAGACCAGC	lambda-EXOB
CCTGTAAGGCACAATAAT	lambda-EXOB
CTGGCTATTCAAAAAATT	lambda-EXOB
CGCGAGAAACCAAACATA	lambda-EXOB
CACGGCAAACACACTATA	lambda-EXOB
CAGGCCATGCATAATATA	lambda-EXOB
GCTATTCTTACTGCGATC	lambda-EXOB
CCGGATATACAAACAAAT	lambda-EXOB
GTAATACTAAAGGGCACC	lambda-EXOB
CCGGACATCCCGATTATA	lambda-EXOB
CGCGAAAGTCCCAGTACC	lambda-EXOB
CCAGGAATTCGTAATAAA	lambda-EXOB
GTAATCCTAAGTGTAAGT	lambda-EXOB
CACGCAATTCTTATTAAA	lambda-EXOB
GTTACGCCGACTGGAATC	lambda-EXOB
GCCAGACCAAGTGTCAAA	lambda-EXOB
GCAATGCCCATAGGTAAT	lambda-EXOB
CATGAAACACTCACTAAA	lambda-EXOB
CAAGCCACCCTTAATATG	lambda-EXOB
CACGACATCCAGATCAAA	lambda-EXOB
CTCGTCACGCTAAATATA	lambda-EXOB
CCCGACACCCTAAAGATC	lambda-EXOB
CACGCGAGCCCCATTAGC	lambda-EXOB
CTCGCCAAGCATACTAAA	lambda-EXOB
GCAAACCCTATTGCAACT	lambda-EXOB
GACAAACTTAAAGATATT	lambda-EXOB
CATGAAACGCCAAATAAC	lambda-EXOB
CATGATACTCGCAGTACA	lambda-EXOB
GGAACCCAAACTGTAACA	lambda-EXOB
GGCAAACAAATGGGCAAC	lambda-EXOB
GATAAGCCTAACGGTAAA	lambda-EXOB
CGAGAAATACGGATCACA	lambda-EXOB
GTAAACCTAAGTGTAACC	lambda-EXOB
CCTGACAATCACATAACA	lambda-EXOB
GACAGTCATACAGGAAGA	lambda-EXOB
GCAACACACACAGAGAGC	lambda-EXOB
GGTAAACCAACGGCAAAG	lambda-EXOB
CCAGTAATACATAACAAG	lambda-EXOB
GCCATACCCATAGAGAGA	lambda-EXOB
GAGACACAAACTGATATA	lambda-EXOB
GGCAGACCTATAGCTAAT	lambda-EXOB
CACGTGAACCTTACTAAA	lambda-EXOB
CCCGCAACTCATAAAATC	lambda-EXOB
GCGACACTAATAGCTACG	lambda-EXOB
GCGACACGAAGCGAAAAG	lambda-EXOB
CGAGATAATCCAAGTAAA	lambda-EXOB
CCGGGAACGCTTAACACT	lambda-EXOB
GTTACCCAGACCGACAAC	lambda-EXOB
GTAATCCACACCGATATG	lambda-EXOB
CTCGAAATCCACAGAAAA	lambda-EXOB
CTAGCAACACTCACCAAT	lambda-EXOB
CATGACAGCCAGATTACA	lambda-EXOB
CCCGAAAAGCTCACGAGT	lambda-EXOB
GCTAAACCGAACGAGAAA	lambda-EXOB
GTCAACCTAAAAGTTAAC	lambda-EXOB
GAGACTCGAAGGGGAAAA	lambda-EXOB
GAGATACAGAAGGTAAAA	lambda-EXOB
CTTGCAATTCAAAATACA	lambda-EXOB
CGCGTAAAACTAACTAAA	lambda-EXOB
CAGGATAGTCCTAACAAC	lambda-EXOB
GACACACGCACCGTAACG	lambda-EXOB
GACATTCTCACCGTAAAC	lambda-EXOB
GTTAAACTTAGAGTAAAA	lambda-EXOB
GACAGTCCCAGAGTCAGT	lambda-EXOB
CTTGCAAAACGAAATATC	lambda-EXOB
CTAGTTAAACTAAACAGT	lambda-EXOB
CGTGAAAACCCTAAAAAA	lambda-EXOB
CTCGGTACTCTTATAAAC	lambda-EXOB
GTTAGCCGCATGGACACA	lambda-EXOB
CGTGTGAACCCTATTAAC	lambda-EXOB
GCAAGACCTACAGACACA	lambda-EXOB
CTTGTTACTCAAAGCATA	lambda-EXOB
CCAGTCAGGCGTATAACT	lambda-EXOB
CGCGATAGGCCTAGAACG	lambda-EXOB
GTCAACCCGAGAGATAGT	lambda-EXOB
GACATACATAACGGCAAA	lambda-EXOB
CCCGCAACACTTACGATG	lambda-EXOB
GCAAATCGAAACGTTAGA	lambda-EXOB
GAAAAACTGAACGGGATC	lambda-EXOB
GATACGCGCATAGATAGT	lambda-EXOB
CACGCGAGCCTGAAAAAA	lambda-EXOB
CGCGACACCCCAACCAGG	lambda-EXOB
CGCGGCAAGCTAACAAGT	lambda-EXOB
GAAAAGCAAACAGGAACA	lambda-EXOB
CAGGTGACTCTGAATAAT	lambda-EXOB
CTCGAAAAACATACCAAC	lambda-EXOB
GGTATACTTAACGGCATC	lambda-EXOB
CTCGTGATCCGGAGCACT	lambda-EXOB
CACGTGACACAAACTACA	lambda-EXOB
CACGAGAAGCCTACGAAT	lambda-EXOB
GAGATGCCGAAAGCTACG	lambda-EXOB
CTTGGAACGCATACTAAA	lambda-EXOB
GCTAATCGTAAAGCAACA	lambda-EXOB
CTTGCGAAACATAATATA	lambda-EXOB
GCCACCCGGATTGCGACC	lambda-EXOB
CCAGACATGCTTACAAAA	lambda-EXOB
GTAAACCAGAATGGCAAA	sIns1
GTAAAGCCCAACGCCAAA	sIns1
CATGACACGCTTAACAAA	sIns1
GCAAGCCTTAGAGAAATA	sIns1
CGAGCCATACTAACGATG	sIns1
GATACTCCGAAAGCAAAT	sIns1
GTAAACCAGACAGAGACT	sIns1
GAAACACCCACAGCAAAT	sIns1
GATATCCACAGCGTGATT	sIns1
GAAAGTCTAAAAGAAACG	sIns1
GAAAAACCCAAGGCGAGT	sIns1
GACAAACGCAAAGTCACC	sIns1
CCGGAAAACCGGATAACA	sIns1
GCTAGTCTAAGGGAAACA	sIns1
CCGGTCAGTCTAAGAATT	sIns1
CTGGCCATCCGAAGCACA	sIns1
CTCGGAAACCTTACGATT	sIns1
GACAGACCCATTGTTAGA	sIns1
CAAGAAATTCTTAAAATA	sIns1
GGAAATCACAATGCCATT	sIns1
CTAGACACTCTGATAACA	sIns1
GGAAAACTAATAGCTATC	sIns1
GATACACCTAATGACACT	sIns1
CATGTCATACAAATTAGT	sIns1
CGTGTCACTCGAAGAAGC	sIns1
CCAGTTACCCCCATAATT	sIns1
CGCGTTAAACACACTAGA	sIns1
CACGTGACTCAAACAAAG	sIns1
GGCAAGCATATAGAAATA	sIns1
GCTATTCATAAGGATAGT	sIns1
CCAGTGAACCGGATCATG	sIns1
CCCGCGATTCCGACCAAT	sIns1
GCCAAACTAAATGATAAA	sIns1
GCCAAACCCAACGCAAGT	sIns1
CCCGAAACACCGATTATA	sIns1
CAAGCAATCCCCACCAAT	sIns1
GTGACGCCAAACGCAAAC	sIns1
CTTGCAACTCTTATAACA	sIns1
CCTGTAAAACAGATTACG	sIns1
GCCACTCGCATCGTTAAA	sIns1
CGCGCGACCCACAGGATA	sIns1
GACAAACCGAGCGACATA	sIns1
GATACCCTAACGGACACA	sIns1
GCCAGCCAGAACGACAAG	sIns1
CCGGCCAGTCGAACAAGT	sIns1
GGCATTCGCATAGGAATG	sIns1
GTCAAACACAGAGACAAA	sIns1
GACATTCAGACAGACAAT	sIns1
CTCGGTAAACACAGGACT	sIns1
CTTGGCACCCTTAAAATA	sIns1
GGCAACCAGAATGCCATT	sIns1
GCAATCCGGATTGAAAAT	sIns1
CGAGCAACTCAAATAAAT	sIns1
GACAACCGAAACGCCACG	sIns1
CTCGCAACGCTAATAACT	sIns1
GTCATACATACCGCTAAG	sIns1
CCTGTAACGCAAAACAAA	sIns1
CGGGAAACGCAGATGAAA	sIns1
CACGAGAAGCTAATAACG	sIns1
CTGGATAACCACATCAAC	sIns1
GAAATCCCGACTGAAATA	sIns1
CACGAGATGCGCAACAAA	sIns1
CTAGAGAGACACATTATC	sIns1
GACAGTCCAAAGGCTACG	sIns1
GCGATACATACTGTGATT	sIns1
CTAGGAACACAAAAAATA	sIns1
GACACACCGAATGTCAAG	sIns1
CATGGCAATCAGAGAATA	sIns1
CTTGCCAATCCGAAGAGA	sIns1
GTAAAACAAATAGGTACA	sIns1
GTCAGCCGCAAAGAGAAG	sIns1
CACGATACACCCACAAAA	sIns1
GCCACACCGAGAGGCAAC	sIns1
GTCAGGCAAACTGCAACG	sIns1
CAAGATAATCAGACAAAT	sIns1
CCCGACACACCTATAAAA	sIns1
GCAATCCCCATGGACAGC	sIns1
CTAGCTAGCCGTATGAAC	sIns1
CTAGACACTCATATCAAC	sIns1
GAAACTCTTAGTGTAACT	sIns1
GTAAACCAGATAGGAAAT	sIns1
GCTAGACAGAGGGACACA	sIns1
CTAGTTATACACAGCACT	sIns1
GAGAGGCAAAAAGTCAAA	sIns1
GCTACTCCGAAGGTAACC	sIns1
CGAGCAATTCCTAAGAAC	sIns1
CCCGTTAAGCGAATAATT	sIns1
GCTAAACCCACCGGGACC	sIns1
GACAGTCGCACCGTTACC	sIns1
CTAGTTAATCGAAAAATG	sIns1
GCGACACATATGGTGACT	sIns2
CACGCCAGTCCTAGCAAC	sIns2
CAGGCAAATCTCAGTATC	sIns2
CAAGGCAAGCTGACAAGA	sIns2
GATATGCAGACTGATACA	sIns2
GCCACGCACACCGTCAAA	sIns2
CTGGCGAACCGGACTACG	sIns2
CCCGCAACGCAAAAGAAC	sIns2
GTCACACCTAATGGAAAA	sIns2
CCAGGTATTCCAACTAAA	sIns2
GACAAGCCCAACGTAACT	sIns2
CCCGTAATACCAATAATC	sIns2
GCAACACTTAATGATAGA	sIns2
GAAATTCATATCGGAAAA	sIns2
GAAAAACTAACTGTCAAT	sIns2
CTCGCAACCCATAAGATG	sIns2
CGAGAAACGCTTAACAAC	sIns2
CACGTTAAACAGAGAAAA	sIns2
GCCAACCAAACAGCGATC	sIns2
CGTGACATACCAATTAGA	sIns2
GCAAAGCGCAACGCGACG	sIns2
GTGAGCCATACAGTGAAA	sIns2
CATGCTAGACTTAAAAAC	sIns2
CGCGGAAGTCCAAACAAT	sIns2
CATGTAATACATATCACA	sIns2
GATAGACAAATAGCAAAT	sIns2
GACACCCCTACCGCAAAA	sIns2
CACGCTATACGAAAAATT	sIns2
CCCGGCAGACCCACTATA	sIns2
GCTATCCATACAGACAAA	sIns2
CCGGTTATGCTCACAATA	sIns2
CGCGCAATACAGAAGAAT	sIns2
CCTGCCAACCCGACAAAT	sIns2
CTAGTGAACCATAAAAAT	sIns2
GACATACTAACAGTAAAA	sIns2
CCTGTGATTCGAAAAAGA	sIns2
GTCAAACATAACGGCACA	sIns2
CAAGAGAGACTAAAGAAT	sIns2
CTCGCGATCCGCATCAGC	sIns2
GCAAACCATAAGGTAATG	sIns2
CCCGTAAGCCGCACCAGC	sIns2
GAAAGACACAATGTGAAC	sIns2
CCCGCCATTCGTACAAAC	sIns2
CCAGTAACCCTTAATAGA	sIns2
CTTGGGACTCAAATAACC	sIns2
CGGGAAAGCCTCATAAAC	sIns2
CTAGTTAGTCGCACAACT	sIns2
CCAGAAAACCGCAAAATA	sIns2
GGCACGCATAAAGCTAGC	sIns2
GCCACACTTACCGTGATG	sIns2
CACGGTATGCAAAGCAAT	sIns2
CAAGATATGCAGAAAAAA	sIns2
GAAACCCATAGTGACAGA	sIns2
CATGAAAATCCCATAATC	sIns2
CGCGGAATGCGGAAAATT	sIns2
GGAAATCCCAAGGACAGT	sIns2
CGTGCAACCCCTACCATA	sIns2
CGCGCTACCCATACCATC	sIns2
CCAGCCAATCGCAATATA	sIns2
GCTAGCCGGATGGGGACA	sIns2
CCAGTCACCCTCAATAAT	sIns2
GAAATACTCACTGGGAAT	sIns2
GACATACAGAGGGTCATA	sIns2
GTCAAGCATATAGAAATA	sIns2
GTTAGACACACAGTAACA	sIns2
GCAACGCTTAAAGTCAAT	sIns2
CGCGAAACACTAAATAGA	sIns2
CGAGCTATTCACACTATA	sIns2
GACATCCGAACTGGGAAT	sIns2
GAAAACCCTAGCGCAATG	sIns2
GAAATCCCCATCGTAAGT	sIns2
GCTAAACCGAACGAGAAC	sIns2
GCCAGTCGTAGCGAAAAA	sIns2
CGAGCCATACCTACCATG	sIns2
CTCGAAAGTCTCATGATC	sIns2
CCTGTGAACCATAGCATG	sIns2
GTTAACCCAACTGGCATG	sIns2
GAAACCCGAATCGCGATA	sIns2
GATATCCTTACAGAGATA	sIns2
GTGAAACAGACAGATATT	sIns2
CAGGGCACTCATACTACC	sIns2
GACAGTCAAACTGAAATC	sIns2
GTCAAACAGACTGTAATG	sIns2
GCGACACACAAAGCAACT	sIns2
CAGGGAATACGAATCAAA	sIns2
GTAATTCTTATTGAAATA	sIns2
CCTGAAACACCAATGAAA	sIns2
GGTAAACGCATTGATAGA	sIns2
GCTACACCCATTGAGATA	sIns2
CCAGCAACCCAAATTAAC	sIns2
CCAGGAACCCCAATCAAA	sIns2
GCGAATCTCAGGGAAAAT	sIns2
CTTGGTACCCCAACTAAA	sIns2
GTTACGCATAACGAAATT	sIns2
GAAACCCCCACGGATATC	sIns2
GATAAACAAACAGAAAAA	sIns2
GCCATGCTCACAGGTACC	sIns2
CGCGGCACCCTGATCAAG	sIns2
GGAACTCACAGAGAAAGG	sIns2
GGCACTCCAACGGCCAGA	sIns2
CTAGGCAAACACATAAAG	sIns2
GTAATTCTCAAAGCAATA	sIns2
CTTGCAAACCGTATGAGA	sIns2
CGTGATAGACCTATTATA	sIns2
GCGAAACAAATAGGCACG	sIns2
GAAACTCATAAAGTCAAA	sIns2
CGCGCCAGGCTAATTAGA	sIns2
CTCGATAAACACATTAAT	sIns2
GACAAGCCCATTGCTAAC	sIns2
CTCGTCATTCACAAAAAC	sIns2
CTGGCTAAACCCACCATT	sIns2
GTTACACATATCGCCATT	sIns2
GATATCCTAAAAGCTAGC	sIns2
CCCGATAGCCAGATCAAT	sIns2
GAAAATCCCACCGACAAT	sIns2
CCCGCAAAGCAAAGGATA	sIns2
GCCAAACCCACAGGCACT	sIns2
CCGGCCACCCTTAAAATA	sIns2
GTTATGCCGAACGCAATG	sIns2
CAAGTCAACCCCAATAAG	sIns2
GCTAGCCTTATAGTTAGG	sIns2
GCAATTCTAACGGCAACT	sIns2
GCCAGCCCAACAGCTATA	sIns2
GCAACACCAACCGAAATA	sIns2
CAAGCAATACGAATTAAA	sIns2
GAAACTCCGAAGGGAACG	sIns2
CGGGAAACGCCCAGAAAA	sIns2
CTGGCCAGACTCACAACT	sIns2
CGGGCAAATCTAATTATA	sIns2
GCCATGCTCACCGTTAAG	sIns2
CTGGACAAACAGATAAGA	sIns2
CCCGGGACACCGAGCACA	sIns2
GATACGCTGAAGGGGATC	sIns2
CGGGCAAAACGAACCAAG	sIns2
CCAGCAACACGAATCATT	sIns2
CCAGTAAAGCGAACCATA	sIns2
CACGCAACCCAAAATATT	sIns2
GAAAGTCGGAACGAAAAA	sIns2
CTAGTAACACACATTAAC	sIns2
GACACTCCAAACGTAAAT	sIns2
CATGTGAAACTGAAAATA	sIns2
GAAAAACAAAGAGTGATG	sIns2
CGAGTTAAACGAATCAGA	sIns2
CTCGCAAGTCTTATTATA	sIns2
GCCAAGCTGAACGGCACG	sIns2
CGAGACAGCCTTACGATA	sIns2
CTCGTAATACAGACCAGG	sIns2
CCAGAAACACCTACAAAT	sIns2
CAAGAAAGGCAAATAACC	sIns2
CGAGTGATTCCAATAAAA	sIns2
CAAGACACGCAAAATAAT	sIns2
GTCAGACAGATCGCTATT	sIns2
GCCAACCTCAATGCCATA	sIns2
GTCACCCTTATCGCAAAG	sIns2
GAAACACACAACGACATT	sIns2
CCTGAGAGCCTGATAACT	sIns2
GCCAAGCCTACCGTTATG	sIns2
GACACCCACACGGACATC	sIns2
CAAGGAACGCTAATGATG	sIns2
GACACTCCTACAGTCATA	sIns2
GATACACACACCGCTAAG	sIns2
CTAGTCAACCTTAGTAAC	sIns2
GAAACTCATACAGAGATG	sIns2
GACACTCGAACTGGAACA	sIns2
GAAACCCACATAGTAAGT	sIns2
GGAACACGCAACGATATT	sIns2
CCTGGCAGCCTCAACAAA	sIns2
GCTATTCTGAGAGTCAGT	sIns2
GGTAGACCGATCGTTATG	sIns2
CACGGCACACAGAATAAC	UASrpg
GCCACCCGAAAAGACATA	UASrpg
GTCAATCTCAACGGAACA	UASrpg
CCCGTAAATCCTAGGATA	UASrpg
CCGGCTATACACATGACA	UASrpg
CAAGTCACACTAACAATC	UASrpg
CACGATACTCATAAGATG	UASrpg
GAAACTCATAAAGTAACC	UASrpg
CCGGAAAAACCTACCAAC	UASrpg
GAAATCCTTAACGCAAAT	UASrpg
CTAGACAGTCCTAGCAAT	UASrpg
CAAGCGAGGCCTAAGAAT	UASrpg
GCAATGCCTACTGATATT	UASrpg
GCGAACCACACTGAAATA	UASrpg
GACAACCTGATGGAAAGA	UASrpg
CATGCGACACTTAAGATT	UASrpg
CAAGGCAAACATACGAAG	UASrpg
GACACGCCCAAAGATAAA	UASrpg
CATGACAAACACAGAACT	UASrpg
CCGGCGAATCGAACCATT	UASrpg
GACAACCCCAAGGGCATG	UASrpg
CCCGTAACGCGGACTAAT	UASrpg
CACGACACACTAATTATA	UASrpg
GATAATCCAAGCGCAAAC	UASrpg
CGGGTTAGCCTCATAAAA	UASrpg
CACGTAAATCACAGCAAA	UASrpg
GGCAAGCCCAATGTGAAC	UASrpg
GCAACGCACACCGGCATG	UASrpg
CCAGTCACGCGGAAAATG	UASrpg
CTAGCAAAACAAAAAAAA	UASrpg
CACGAGATCCCAAAGAAT	UASrpg
GCAAGACGAACTGTGAGC	UASrpg
CCTGGTACCCCGATGATG	UASrpg
CGCGCGACGCGTAATATA	UASrpg
CGTGCGATTCACAAAAAA	UASrpg
CATGCGATACGTACGAAA	UASrpg
GCAAAACTAACGGACACC	UASrpg
CCTGCCACACCCATCAGC	UASrpg
CACGCGACCCTAATCAGC	UASrpg
GCAATCCCTAAGGATAAA	UASrpg
CCAGAAACGCCAATGAGT	UASrpg
CCAGTCAATCAAAACATA	UASrpg
GCCATACTAATGGATACC	UASrpg
CCAGGCAATCCCAAGAAA	UASrpg
GACAATCCCAGCGCCACC	UASrpg
CTAGCAAAACAAAATAAG	UASrpg
GCAACCCAAAAAGTGACA	UASrpg
GACAACCACAATGCTAAA	UASrpg
CCGGGAAATCTTATGAAA	UASrpg
GTAATGCTTAATGGAAAG	UASrpg
CTAGCAAGCCCCACAATA	UASrpg
CATGTAACACTAAACACA	UASrpg
CCCGCAAACCAAAACAGT	UASrpg
CCAGCGAGACGTATAACA	UASrpg
GCCACGCGAAAAGGCAGC	UASrpg
CCCGGAACTCTTAAAATA	UASrpg
CTCGGGATTCCTAGCAGC	UASrpg
GCTAAGCAAACAGGGAAA	UASrpg
CGGGCCATCCCTATAATA	UASrpg
GATACTCAGACCGTCAAG	UASrpg
CTAGGGATGCCAAGAAAC	UASrpg
CCGGTGAGCCCGAATATA	UASrpg
CCTGCCACACGAATAAGG	UASrpg
GTTAATCGGATAGATACG	UASrpg
GACAACCCGACTGATAAC	UASrpg
CGAGCTAAACATAATAAA	UASrpg
CAGGTGATACTTATCATC	UASrpg
GCTAGGCAGAGCGGCACA	UASrpg
CATGAGATACATATAATG	UASrpg
GCCATGCCAATTGCTATA	UASrpg
CGCGCTAAACATACGACG	UASrpg
GCCATGCACAAGGAGATA	UASrpg
CCCGCCAGGCTTACAAGA	UASrpg
GTGAACCTTACAGACACA	UASrpg
GACACGCACAAGGTGAAC	UASrpg
CGTGGCAATCAAACCATG	UASrpg
CTCGAAAAACGAATAAAG	UASrpg
GTGAACCCAACAGTGAAG	UASrpg
GGCACTCCAAACGGCATC	UASrpg
GATATGCTTATAGCGAAT	UASrpg
GGTAAACACATTGAAATG	UASrpg
GCCAAGCTAACGGCCAAT	UASrpg
CCCGCTATTCGCACAAAG	UASrpg
GCGAACCGAAAAGAAATC	UASrpg
CAGGAGAATCTAACCAGC	UASrpg
CTTGACACACGGACTAAC	UASrpg
CGCGATAAACGAATAAAG	UASrpg
GCGACACGAACGGTCAAC	UASrpg
GACAACCCTACAGAAAGA	UASrpg
GACAAACCGAAAGTGAAT	UASrpg
CCAGCGAATCATATTAAA	UASrpg
CTGGCGACCCAAACCACC	UASrpg
GCAACCCTGAAAGTAATA	UASrpg
CTAGTAAACCAAACGATA	UASrpg
CTTGTCAATCACAGGAGT	UASrpg
GCTAAGCGTAGTGATATT	UASrpg
GCCACTCAAAAAGTCACA	UASrpg
CTGGCCACTCTTACCACA	UASrpg
CTTGACAACCTCACTATT	UASrpg
GACATTCAGAGAGCAACA	UASrpg
